#FormatVersion Mauve1
#Sequence1File	genomes/aacoi.fasta
#Sequence1Format	FastA
#Sequence2File	genomes/aacok.fasta
#Sequence2Format	FastA
#Sequence3File	genomes/abkuy.fasta
#Sequence3Format	FastA
#Sequence4File	genomes/abkvf.fasta
#Sequence4Format	FastA
#Sequence5File	genomes/abkwz.fasta
#Sequence5Format	FastA
#Sequence6File	genomes/acvdd.fasta
#Sequence6Format	FastA
#Sequence7File	genomes/acvde.fasta
#Sequence7Format	FastA
#Sequence8File	genomes/acveb.fasta
#Sequence8Format	FastA
#Sequence9File	genomes/acvec.fasta
#Sequence9Format	FastA
#Sequence10File	genomes/acvgh.fasta
#Sequence10Format	FastA
#Sequence11File	genomes/acvgm.fasta
#Sequence11Format	FastA
#Sequence12File	genomes/adpuj.fasta
#Sequence12Format	FastA
#Sequence13File	genomes/adpuv.fasta
#Sequence13Format	FastA
#Sequence14File	genomes/adpvv.fasta
#Sequence14Format	FastA
#Sequence15File	genomes/adpwf.fasta
#Sequence15Format	FastA
#Sequence16File	genomes/adpxi.fasta
#Sequence16Format	FastA
#Sequence17File	genomes/adpxx.fasta
#Sequence17Format	FastA
#Sequence18File	genomes/adpzh.fasta
#Sequence18Format	FastA
#Sequence19File	genomes/adqbz.fasta
#Sequence19Format	FastA
#Sequence20File	genomes/adqef.fasta
#Sequence20Format	FastA
#Sequence21File	genomes/adqfs.fasta
#Sequence21Format	FastA
#Sequence22File	genomes/adtqs.fasta
#Sequence22Format	FastA
#Sequence23File	genomes/adtrc.fasta
#Sequence23Format	FastA
#Sequence24File	genomes/adttd.fasta
#Sequence24Format	FastA
#Sequence25File	genomes/adttj.fasta
#Sequence25Format	FastA
#Sequence26File	genomes/adttw.fasta
#Sequence26Format	FastA
#Sequence27File	genomes/adtuj.fasta
#Sequence27Format	FastA
#Sequence28File	genomes/adtvh.fasta
#Sequence28Format	FastA
#BackboneFile	full_alignment.xmfa.bbcols
